25
25
VVVVVVVWWWWWWWWWWWVVVVVVV
VVWWWWWWEEEEEEEEEWWWWWWVV
VWWEEEEEEEEEEEEEEEEEEEWWV
VWEEEEEEEEEEEEEEEEEEEEEWV
VWEEWWWWEEEEEEEEEWWWWEEWV
VWEEWEEWWEEEEEEEWWEEWEEWV
VWEEWEEEWWEEEEEWWEEEWEEWV
WWEEWWEEEWEEEEEWEEEWWEEWW
WEEEEWWEEWEEEEEWEEWWEEEEW
WEEEEEWWWWEEEEEWWWWEEEEEW
WEEEEEEEEEEEEEEEEEEEEEEEW
WEEEEEEEEEEEEEEEEEEEEEEEW
WEEEEEEEEEEEBEEEEEEEEEEEW
WEEEEEEEEEEEEEEEEEEEEEEEW
WEEEEEEEEEEEEEEEEEEEEEEEW
WEEEEEWWWWEEEEEWWWWEEEEEW
WEEEEWWEEWEEEEEWEEWWEEEEW
WWEEWWEEEWEEEEEWEEEWWEEWW
VWEEWEEEWWEEEEEWWEEEWEEWV
VWEEWEEWWEEEEEEEWWEEWEEWV
VWEEWWWWEEEEEEEEEWWWWEEWV
VWEEEEEEEEEEEEEEEEEEEEEWV
VWWEEEEEEEEEEEEEEEEEEEWWV
VVWWWWWWEEEEEEEEEWWWWWWVV
VVVVVVVWWWWWWWWWWWVVVVVVV