25
25
EEEEEEEEEEEWWWEEEEEEEEEEE
EEEEEEEEEEWWEWWEEEEEEEEEE
EEEEEEEEEWWEEEWWEEEEEEEEE
EEEEEEEEWWEEEEEWWEEEEEEEE
EEEEEEEWWEEEEEEEWWEEEEEEE
EEEEEEWWEEEEEEEEEWWEEEEEE
EEEEEWWEEEEEEEEEEEWWEEEEE
EEEEWWEEEEEWWWEEEEEWWEEEE
EEEWWEEEEEEEEEEEEEEEWWEEE
EEWWEEEEEEEEEEEEEEEEEWWEE
EWWEEEEEEEEEEEEEEEEEEEWWE
WWEEEEEWEEEEEEEEEWEEEEEWW
WEEEEEEWEEEEBEEEEWEEEEEEW
WWEEEEEWEEEEEEEEEWEEEEEWW
EWWEEEEEEEEEEEEEEEEEEEWWE
EEWWEEEEEEEEEEEEEEEEEWWEE
EEEWWEEEEEEEEEEEEEEEWWEEE
EEEEWWEEEEEWWWEEEEEWWEEEE
EEEEEWWEEEEEEEEEEEWWEEEEE
EEEEEEWWEEEEEEEEEWWEEEEEE
EEEEEEEWWEEEEEEEWWEEEEEEE
EEEEEEEEWWEEEEEWWEEEEEEEE
EEEEEEEEEWWEEEWWEEEEEEEEE
EEEEEEEEEEWWEWWEEEEEEEEEE
EEEEEEEEEEEWWWEEEEEEEEEEE