25
25
WWWWWWWWWWWWWWWWWWWWWWWWW
WEEEEEEEEEEEEEEEEEEEEEEEW
WEEEEEEEEEEEEEEEEEEEEEEEW
WEEEEEEEEEEEEEEEEEEEEEEEW
WEEEEEEEEEEEEEEEEEEEEEEEW
WEEEEWWWWEEEEEEEWWWWEEEEW
WEEEEWWWWEEEEEEEWWWWEEEEW
WEEEEWWWWEEEEEEEWWWWEEEEW
WEEEEWWWWEEEEEEEWWWWEEEEW
WEEEEEEEEEEEEEEEEEEEEEEEW
WEEEEEEEEEEEEEEEEEEEEEEEW
WEEEEEEEEEEEEEEEEEEEEEEEW
WEEEEEEEEEEEBEEEEEEEEEEEW
WEEEEEEEEEEEEEEEEEEEEEEEW
WEEEEEEEEEEEEEEEEEEEEEEEW
WEEEEEEEEEEEEEEEEEEEEEEEW
WEEEEWWWWEEEEEEEWWWWEEEEW
WEEEEWWWWEEEEEEEWWWWEEEEW
WEEEEWWWWEEEEEEEWWWWEEEEW
WEEEEWWWWEEEEEEEWWWWEEEEW
WEEEEEEEEEEEEEEEEEEEEEEEW
WEEEEEEEEEEEEEEEEEEEEEEEW
WEEEEEEEEEEEEEEEEEEEEEEEW
WEEEEEEEEEEEEEEEEEEEEEEEW
WWWWWWWWWWWWWWWWWWWWWWWWW
