25
25
VVVVVVVVVVVWWWVVVVVVVVVVV
VVVVVVVVVVVWEWVVVVVVVVVVV
VVWWWWWWWWWWEWWWWWWWWWWVV
VVWEEEEEEEEEEEEEEEEEEEWVV
VVWEEEEEEEEEEEEEEEEEEEWVV
VVWEEEEEEEEEEEEEEEEEEEWVV
VVWEEEEEEEEEEEEEEEEEEEWVV
VVWEEEEEEEEEEEEEEEEEEEWVV
VVWEEEEEWWWEEEWWWEEEEEWVV
VVWEEEEEWWEEEEEWWEEEEEWVV
VVWEEEEEWEEEEEEEWEEEEEWVV
WWWEEEEEEEEEEEEEEEEEEEWWW
WEEEEEEEEEEEBEEEEEEEEEEEW
WWWEEEEEEEEEEEEEEEEEEEWWW
VVWEEEEEWEEEEEEEWEEEEEWVV
VVWEEEEEWWEEEEEWWEEEEEWVV
VVWEEEEEWWWEEEWWWEEEEEWVV
VVWEEEEEEEEEEEEEEEEEEEWVV
VVWEEEEEEEEEEEEEEEEEEEWVV
VVWEEEEEEEEEEEEEEEEEEEWVV
VVWEEEEEEEEEEEEEEEEEEEWVV
VVWEEEEEEEEEEEEEEEEEEEWVV
VVWWWWWWWWWWEWWWWWWWWWWVV
VVVVVVVVVVVWEWVVVVVVVVVVV
VVVVVVVVVVVWWWVVVVVVVVVVV