25
25
VVVVVVVVVVVWWWVVVVVVVVVVV
VVVVVVVVVVWWEWWVVVVVVVVVV
VVVVVVVVVWWEEEWWVVVVVVVVV
VVVVVVVVWWEEEEEWWVVVVVVVV
VVVVVVVWWEEEEEEEWWVVVVVVV
VVVVVVWWEEEEEEEEEWWVVVVVV
VVVVVWWEEEEEEEEEEEWWVVVVV
VVVVWWEEEEEWWWEEEEEWWVVVV
VVVWWEEEEEEEEEEEEEEEWWVVV
VVWWEEEEEEEEEEEEEEEEEWWVV
VWWEEEEEEEEEEEEEEEEEEEWWV
WWEEEEEWEEEEEEEEEWEEEEEWW
WEEEEEEWEEEEBEEEEWEEEEEEW
WWEEEEEWEEEEEEEEEWEEEEEWW
VWWEEEEEEEEEEEEEEEEEEEWWV
VVWWEEEEEEEEEEEEEEEEEWWVV
VVVWWEEEEEEEEEEEEEEEWWVVV
VVVVWWEEEEEWWWEEEEEWWVVVV
VVVVVWWEEEEEEEEEEEWWVVVVV
VVVVVVWWEEEEEEEEEWWVVVVVV
VVVVVVVWWEEEEEEEWWVVVVVVV
VVVVVVVVWWEEEEEWWVVVVVVVV
VVVVVVVVVWWEEEWWVVVVVVVVV
VVVVVVVVVVWWEWWVVVVVVVVVV
VVVVVVVVVVVWWWVVVVVVVVVVV