25
25
EEEEEEEEEEEWWWEEEEEEEEEEE
EEEEEEEEEEEWEWEEEEEEEEEEE
EEWWWWWWWWWWEWWWWWWWWWWEE
EEWEEEEEEEEEEEEEEEEEEEWEE
EEWEEEEEEEEEEEEEEEEEEEWEE
EEWEEEEEEEEEEEEEEEEEEEWEE
EEWEEEEEEEEEEEEEEEEEEEWEE
EEWEEEEEEEEEEEEEEEEEEEWEE
EEWEEEEEWWWEEEWWWEEEEEWEE
EEWEEEEEWWEEEEEWWEEEEEWEE
EEWEEEEEWEEEEEEEWEEEEEWEE
WWWEEEEEEEEEEEEEEEEEEEWWW
WEEEEEEEEEEEBEEEEEEEEEEEW
WWWEEEEEEEEEEEEEEEEEEEWWW
EEWEEEEEWEEEEEEEWEEEEEWEE
EEWEEEEEWWEEEEEWWEEEEEWEE
EEWEEEEEWWWEEEWWWEEEEEWEE
EEWEEEEEEEEEEEEEEEEEEEWEE
EEWEEEEEEEEEEEEEEEEEEEWEE
EEWEEEEEEEEEEEEEEEEEEEWEE
EEWEEEEEEEEEEEEEEEEEEEWEE
EEWEEEEEEEEEEEEEEEEEEEWEE
EEWWWWWWWWWWEWWWWWWWWWWEE
EEEEEEEEEEEWEWEEEEEEEEEEE
EEEEEEEEEEEWWWEEEEEEEEEEE