17
17
WWWWWWWWWWWWWWWWW
WVVVVVVVVVVVVVVVW
WVVVVVVVVVVVVVVVW
WVVWWVVVVVVVVVVVW
WVVVWVWWWWWVVVVVW
WVVVWVVWVVVVVVVVW
WVVVWVVWVVVVVVVVW
WVVVWVVWVVVWVVVVW
WVVVWVVWVVVWVVVVW
WVVVWVVWWWWWWVVVW
WVVVVVVVVWVVWVVVW
WVVVVVVVVWVVWVVVW
WVVVVVWWWWVVVVVVW
WVVVVVVVVWVVVVVVW
WVVVVVVVVVVVVVVVW
WVVVVVVVVVVVVVVVW
WWWWWWWWWWWWWWWWW