17
17
WWWWWWWWWWWWWWWWW
WVVVVVVVVVVVVVVVW
WVVVVVVVVVVVVVVVW
WVVVVVVVVVVVVVVVW
WVVVWVVVWVVVWVVVW
WVVVVWVVWVVWVVVVW
WVVVVVVVWVVVVVVVW
WVVVVVVVVVVVVVVVW
WVVVWWWVVVWWWVVVW
WVVVVVVVVVVVVVVVW
WVVVVVVVWVVVVVVVW
WVVVVWVVWVVWVVVVW
WVVVWVVVWVVVWVVVW
WVVVVVVVVVVVVVVVW
WVVVVVVVVVVVVVVVW
WVVVVVVVVVVVVVVVW
WWWWWWWWWWWWWWWWW