15
7
WWWWWWWWWWWWWWW
WVVVVVWVWVVVVVW
WWWWWVWVWVWWWWW
WVVVVVVVVVVVVVW
WWWWWVWVWVWWWWW
WVVVVVWVWVVVVVW
WWWWWWWWWWWWWWW