11
11
EEEEWWWEEEE
EEEEWVWEEEE
EEWWWVWWWEE
EEWVVVVVWEE
WWWVWVWVWWW
WVVVVVVVVVW
WWWVWVWVWWW
EEWVVVVVWEE
EEWWWVWWWEE
EEEEWVWEEEE
EEEEWWWEEEE