17
17
WWWWWWWWWWWWWWWWW
WEEEEEEEEEEEEEEEW
WEEEEEEEEEEEEEEEW
WEEEEEEEEEEEEEEEW
WEEEWEEEWEEEWEEEW
WEEEEWEEWEEWEEEEW
WEEEEEXEWEXEEEEEW
WEEEEEEEEEEEEEEEW
WEEEWWWEEEWWWEEEW
WEEEEEEEEEEEEEEEW
WEEEEEXEWEXEEEEEW
WEEEEWEEWEEWEEEEW
WEEEWEEEWEEEWEEEW
WEEEEEEEEEEEEEEEW
WEEEEEEEEEEEEEEEW
WEEEEEEEEEEEEEEEW
WWWWWWWWWWWWWWWWW