17
9
VVVWWWWWWWWWWWWWV
VVWWEEEEEEEEEEXWW
VWWEEEEEXEEEEEEEW
WWEEXEEEEEEEEWEEW
WEEEEEEEWEEEEEEEW
WEEWEEEEEEEEXEEWW
WEEEEEEEXEEEEEWWV
WWXEEEEEEEEEEWWVV
VWWWWWWWWWWWWWVVV