17
17
WWWWWWWWWWWWWWWWW
WEEEEEEEEEEEEEEEW
WEWWEEEEEEEEEWWEW
WEWEEEEEEEEEEEWEW
WEEEEEEEEEEEEEEEW
WEEEEWWWEWWWEEEEW
WEEEEWXEEWXWEEEEW
WEEEEWWWEWEWEEEEW
WEEEEEEEEEEEEEEEW
WEEEEWEWEWWWEEEEW
WEEEEWXWEEXWEEEEW
WEEEEWWWEWWWEEEEW
WEEEEEEEEEEEEEEEW
WEWEEEEEEEEEEEWEW
WEWWEEEEEEEEEWWEW
WEEEEEEEEEEEEEEEW
WWWWWWWWWWWWWWWWW