15
5
EEEWWWWWWWWWWWE
WWWWEEEEWEEEEWW
WEEWEEWEWEEEEEW
WWEEEEWEEEEWWWW
EWWWWWWYWWWWEEE
