9
9
WWWWWWWWW
WEEEEEEEW
WEEEEEEEW
WEEWWWEEW
WEEWWWEEW
WEEWWWEEW
WEEEEEEEW
WEEEEEEEW
WWWWWWWWW
