17
9
EEEWWWWWWWWWWWWWE
EEWWEEEEEEEEEEXWW
EWWEEEEEXEEEEEEEW
WWEEXEEEEEEEEWEEW
WEEEEEEEWEEEEEEEW
WEEWEEEEEEEEXEEWW
WEEEEEEEXEEEEEWWE
WWXEEEEEEEEEEWWEE
EWWWWWWWWWWWWWEEE