11
11
VVVVWWWVVVV
VVVVWVWVVVV
VVWWWVWWWVV
VVWXVVVXWVV
WWWVWVWVWWW
WVVVVVVVVVW
WWWVWVWVWWW
VVWXVVVXWVV
VVWWWVWWWVV
VVVVWVWVVVV
VVVVWWWVVVV