23
23
VVVVVVVVWWWWWWWVVVVVVVV
VVVVVVVVWWEEEWWVVVVVVVV
VVVVVVVVWWEEEWWVVVVVVVV
VVVVVVVVWWEEEWWVVVVVVVV
VVVVWWWWWWEEEWWWWWWVVVV
VVVVWWWWWWEEEWWWWWWVVVV
VVVVWWXEEEEEEEEEXWWVVVV
VVVVWWEEEEEEEEEEEWWVVVV
WWWWWWEEWWEEEWWEEWWWWWW
WWWWWWEEWWEEEWWEEWWWWWW
WEEEEEEEEEEEEEEEEEEEEEW
WEEEEEEEEEEEEEEEEEEEEEW
WEEEEEEEEEEEEEEEEEEEEEW
WWWWWWEEWWEEEWWEEWWWWWW
WWWWWWEEWWEEEWWEEWWWWWW
VVVVWWEEEEEEEEEEEWWVVVV
VVVVWWXEEEEEEEEEXWWVVVV
VVVVWWWWWWEEEWWWWWWVVVV
VVVVWWWWWWEEEWWWWWWVVVV
VVVVVVVVWWEEEWWVVVVVVVV
VVVVVVVVWWEEEWWVVVVVVVV
VVVVVVVVWWEEEWWVVVVVVVV
VVVVVVVVWWWWWWWVVVVVVVV