11
11
EEEEWWWEEEE
EWWWWEWWWWE
EWEEEEWEEWE
EWEEEWWEEWE
WWEWEEEEEWW
WEEEWEEWEEW
WEEEEEEWWEW
WWWEWEEEWEW
EEWEEEEEWWW
EEWWWEEWWEE
EEEEWWWWEEE