17
9
VVVWWWWWWWWWWWWWV
VVWWEEEEEEEEEEXWW
VWWXEEEEEEEEEEEEW
WWEEEEEEEEEEEWEEW
WEEEEEEEWEEEEEEEW
WEEWEEEEEEEEEEEWW
WEEEEEEEEEEEEXWWV
WWXEEEEEEEEEEWWVV
VWWWWWWWWWWWWWVVV
