35
35
WWWWWWWWWWWWWWWWWWWWWWWWWWWWWWWWWWW
WWWWWWWWWWWWWWWWWEWWWWWWWWWWWWWWWWW
WWEEEEEEEEEEEEEEEEEEEEEEEEEEEEEEEWW
WWEEEEEEEEEEEEEEEEEEEEEEEEEEEEEEEWW
WWEEWWWWEEEEEEEEEEEEEEEEEEEWWWWEEWW
WWEEWWWWEEEEEEEEEEEEEEEEEEEWWWWEEWW
WWEEWWEEEEEEEEEEEEEEEEEEEEEEEWWEEWW
WWEEWWEEEEEEEEEEEEEEEEEEEEEEEWWEEWW
WWEEEEEEEEEEEEEEEEEEEEEEEEEEEEEEEWW
WWEEEEEEEEEEEEEEEEEEEEEEEEEEEEEEEWW
WWEEEEEEEEWWWWWWEEEWWWWWWEEEEEEEEWW
WWEEEEEEEEWWWWWWEEEWWWWWWEEEEEEEEWW
WWEEEEEEEEWWXEEEEEEWWEXWWEEEEEEEEWW
WWEEEEEEEEWWEEEEEEEWWEEWWEEEEEEEEWW
WWEEEEEEEEWWWWWWEEEWWEEWWEEEEEEEEWW
WWEEEEEEEEWWWWWWEEEWWEEWWEEEEEEEEWW
WWEEEEEEEEEEEEEEEEEEEEEEEEEEEEEEEWW
WEEEEEEEEEEEEEEEEEEEEEEEEEEEEEEEEEW
WWEEEEEEEEEEEEEEEEEEEEEEEEEEEEEEEWW
WWEEEEEEEEWWEEWWEEEWWWWWWEEEEEEEEWW
WWEEEEEEEEWWEEWWEEEWWWWWWEEEEEEEEWW
WWEEEEEEEEWWEEWWEEEEEEEWWEEEEEEEEWW
WWEEEEEEEEWWXEWWEEEEEEXWWEEEEEEEEWW
WWEEEEEEEEWWWWWWEEEWWWWWWEEEEEEEEWW
WWEEEEEEEEWWWWWWEEEWWWWWWEEEEEEEEWW
WWEEEEEEEEEEEEEEEEEEEEEEEEEEEEEEEWW
WWEEEEEEEEEEEEEEEEEEEEEEEEEEEEEEEWW
WWEEWWEEEEEEEEEEEEEEEEEEEEEEEWWEEWW
WWEEWWEEEEEEEEEEEEEEEEEEEEEEEWWEEWW
WWEEWWWWEEEEEEEEEEEEEEEEEEEWWWWEEWW
WWEEWWWWEEEEEEEEEEEEEEEEEEEWWWWEEWW
WWEEEEEEEEEEEEEEEEEEEEEEEEEEEEEEEWW
WWEEEEEEEEEEEEEEEEEEEEEEEEEEEEEEEWW
WWWWWWWWWWWWWWWWWEWWWWWWWWWWWWWWWWW
WWWWWWWWWWWWWWWWWWWWWWWWWWWWWWWWWWW