17
17
WWWWWWWWWWWWWWWWW
WEEEEEEEEEEEEEEEW
WEEEEEEEEEEEEEEEW
WEEWWEEEEEEEEEEEW
WEEEWEWWWWWEEEEEW
WEEEWEXWEEEEEEEEW
WEEEWEEWEEEEEEEEW
WEEEWEEWEEEWEEEEW
WEEEWEEWXEEWEEEEW
WEEEWEEWWWWWWEEEW
WEEEEEEEXWEEWEEEW
WEEEEEEEEWEEWEEEW
WEEEEEWWWWEEEEEEW
WEEEEEEEEWEEEEEEW
WEEEEEEEEEEEEEEEW
WEEEEEEEEEEEEEEEW
WWWWWWWWWWWWWWWWW