35
35
WWWWWWWWWWWWWWWWWWWWWWWWWWWWWWWWWWW
WWWWWWWWWWWWWWWWWEWWWWWWWWWWWWWWWWW
WWEEEEEEEEEEEEEEEEEEEEEEEEEEEEEEEWW
WWEEEEEEEEEEEEEEEEEEEEEEEEEEEEEEEWW
WWEEEEEEEEEEEEEEEEEEEEEEEEEEEEEEEWW
WWEEEEEEEEEEEEEEEEEEEEEEEEEEEEEEEWW
WWEEEEWWWWEEEEEEEEEEEEEEEEEEEEEEEWW
WWEEEEWWWWEEEEEEEEEEEEEEEEEEEEEEEWW
WWEEEEEEWWEEWWWWWWWWWWWEEEEEEEEEEWW
WWEEEEEEWWEEWWWWWWWWWWWEEEEEEEEEEWW
WWEEEEEEWWEEEXWWEEEEEEEEEEEEEEEEEWW
WWEEEEEEWWEEEEWWEEEEEEEEEEEEEEEEEWW
WWEEEEEEWWEEEEWWEEEEEEEEEEEEEEEEEWW
WWEEEEEEWWEEEEWWEEEEEEEEEEEEEEEEEWW
WWEEEEEEWWEEEEWWEEEEEEEWWEEEEEEEEWW
WWEEEEEEWWEEEEWWEEEEEEEWWEEEEEEEEWW
WWEEEEEEWWEEEEWWEEEEEEEWWEEEEEEEEWW
WEEEEEEEWWEEEEWWEEEEEEEWWEEEEEEEEEW
WWEEEEEEWWEEEEWWXEEEEEEWWEEEEEEEEWW
WWEEEEEEWWEEEEWWWWWWWWWWWWWEEEEEEWW
WWEEEEEEWWEEEEWWWWWWWWWWWWWEEEEEEWW
WWEEEEEEEEEEEEEEEEXWWXEEEWWEEEEEEWW
WWEEEEEEEEEEEEEEEEEWWEEEEWWEEEEEEWW
WWEEEEEEEEEEEEEEEEEWWEEEEWWEEEEEEWW
WWEEEEEEEEEEEEEEEEEWWEEEEWWEEEEEEWW
WWEEEEEEEEEEWWWWWWWWWEEEEEEEEEEEEWW
WWEEEEEEEEEEWWWWWWWWWEEEEEEEEEEEEWW
WWEEEEEEEEEEEEEEEEEWWEEEEEEEEEEEEWW
WWEEEEEEEEEEEEEEEEEWWEEEEEEEEEEEEWW
WWEEEEEEEEEEEEEEEEEEEEEEEEEEEEEEEWW
WWEEEEEEEEEEEEEEEEEEEEEEEEEEEEEEEWW
WWEEEEEEEEEEEEEEEEEEEEEEEEEEEEEEEWW
WWEEEEEEEEEEEEEEEEEEEEEEEEEEEEEEEWW
WWWWWWWWWWWWWWWWWEWWWWWWWWWWWWWWWWW
WWWWWWWWWWWWWWWWWWWWWWWWWWWWWWWWWWW