15
5
VVVWWWWWWWWWWWV
WWWWEEEEWEEEEWW
WEEWEEWEWEEEEEW
WWEEEEWEEEEWWWW
VWWWWWWWWWWWVVV