15
7
WWWWWWWWWWWWWWW
WXEEEEWEWEEEEXW
WWWWWEWEWEWWWWW
WEEEEEEEEEEEEEW
WWWWWEWEWEWWWWW
WXEEEEWEWEEEEXW
WWWWWWWWWWWWWWW