17
17
WWWWWWWWWWWWWWWWW
WVVVVVVVVVVVVVVVW
WVWWVVVVVVVVVWWVW
WVWVVVVVVVVVVVWVW
WVVVVVVVVVVVVVVVW
WVVVVWWWVWWWVVVVW
WVVVVWXVVWXWVVVVW
WVVVVWWWVWVWVVVVW
WVVVVVVVVVVVVVVVW
WVVVVWVWVWWWVVVVW
WVVVVWXWVVXWVVVVW
WVVVVWWWVWWWVVVVW
WVVVVVVVVVVVVVVVW
WVWVVVVVVVVVVVWVW
WVWWVVVVVVVVVWWVW
WVVVVVVVVVVVVVVVW
WWWWWWWWWWWWWWWWW