15
7
WWWWWWWWWWWWWWW
WXVVVVWVWVVVVXW
WWWWWVWVWVWWWWW
WVVVVVVVVVVVVVW
WWWWWVWVWVWWWWW
WXVVVVWVWVVVVXW
WWWWWWWWWWWWWWW