35
35
WWWWWWWWWWWWWWWWWWWWWWWWWWWWWWWWWWW
WWWWWWWWWWWWWWWWWEWWWWWWWWWWWWWWWWW
WWEEEEEEEEEEEEEEEEEEEEEEEEEEEEEEEWW
WWEEEEEEEEEEEEEEEEEEEEEEEEEEEEEEEWW
WWEEEEEEEEEEEEEEEEEEEEEEEEEEEEEEEWW
WWEEEEEEEEEEEEEEEEEEEEEEEEEEEEEEEWW
WWEEEEEEEEEEEEEEEEEEEEEEEEEEEEEEEWW
WWEEEEEEEEEEEEEEEEEEEEEEEEEEEEEEEWW
WWEEEEEEWWEEEEEEEEEEEEEEEWWEEEEEEWW
WWEEEEEEWWEEEEEEWWWEEEEEEWWEEEEEEWW
WWEEEEEEEEWWEEEEWWWEEEEWWEEEEEEEEWW
WWEEEEEEEEWWEEEEWWWEEEEWWEEEEEEEEWW
WWEEEEEEEEEEXEEEWWWEEEXEEEEEEEEEEWW
WWEEEEEEEEEEEEEEWWWEEEEEEEEEEEEEEWW
WWEEEEEEEEEEEEEEEEEEEEEEEEEEEEEEEWW
WWEEEEEEEEEEEEEEEEEEEEEEEEEEEEEEEWW
WWEEEEEEEWWWWWEEEEEEEWWWWWEEEEEEEWW
WEEEEEEEEWWWWWEEEEEEEWWWWWEEEEEEEEW
WWEEEEEEEWWWWWEEEEEEEWWWWWEEEEEEEWW
WWEEEEEEEEEEEEEEEEEEEEEEEEEEEEEEEWW
WWEEEEEEEEEEEEEEEEEEEEEEEEEEEEEEEWW
WWEEEEEEEEEEEEEEWWWEEEEEEEEEEEEEEWW
WWEEEEEEEEEEXEEEWWWEEEXEEEEEEEEEEWW
WWEEEEEEEEWWEEEEWWWEEEEWWEEEEEEEEWW
WWEEEEEEEEWWEEEEWWWEEEEWWEEEEEEEEWW
WWEEEEEEWWEEEEEEWWWEEEEEEWWEEEEEEWW
WWEEEEEEWWEEEEEEEEEEEEEEEWWEEEEEEWW
WWEEEEEEEEEEEEEEEEEEEEEEEEEEEEEEEWW
WWEEEEEEEEEEEEEEEEEEEEEEEEEEEEEEEWW
WWEEEEEEEEEEEEEEEEEEEEEEEEEEEEEEEWW
WWEEEEEEEEEEEEEEEEEEEEEEEEEEEEEEEWW
WWEEEEEEEEEEEEEEEEEEEEEEEEEEEEEEEWW
WWEEEEEEEEEEEEEEEEEEEEEEEEEEEEEEEWW
WWWWWWWWWWWWWWWWWEWWWWWWWWWWWWWWWWW
WWWWWWWWWWWWWWWWWWWWWWWWWWWWWWWWWWW