9
9
WWWWWWWWW
WEEEEEEEW
WEEEEEEEW
WEEWXWEEW
WEEXWXEEW
WEEWXWEEW
WEEEEEEEW
WEEEEEEEW
WWWWWWWWW
