11
11
VVVVWWWVVVV
VVVVWEWVVVV
VVWWWEWWWVV
VVWXEEEXWVV
WWWEWEWEWWW
WEEEEEEEEEW
WWWEWEWEWWW
VVWXEEEXWVV
VVWWWEWWWVV
VVVVWEWVVVV
VVVVWWWVVVV