11
11
VVVVWWWVVVV
VWWWWEWWWWV
VWEEEEWEEWV
VWEEEWWEEWV
WWEWEEEEEWW
WEEEWXEWEEW
WEEEEEEWWEW
WWWEWEEEWEW
VVWEEEEEWWW
VVWWWEEWWVV
VVVVWWWWVVV