11
9
WWWWWWWWWWW
WEEEEEEEEEW
WEEEWWWWWEW
WEEEWEEEWEW
WEEEWWWEWEW
WWWEEEWEWWW
EEWWWEWEEEE
EEEEWEWEEEE
EEEEWWWEEEE