23
19
WWWWWWWWWWWWWWWWWWWWWWW
WWWWWWWWWWWEWWWWWWWWWWW
WWEEEEEEEEEEEEEEEEEEEWW
WWEEEEEEEEEEEEEEEEEEEWW
WWEEEEEEWWWWWWWWWWWEEWW
WWEEEEEEWWWWWWWWWWWEEWW
WWEEEEEEEEEEXWWVVWWEEWW
WWEEEEEEEEEEEWWVVWWEEWW
WWEEEEEEEEEEEWWVVWWEEWW
WEEEEEEEEEEEEWWVVWWEEEW
WWEEEEEEEEEEEWWVVWWEEWW
WWWWWWEEEEEEEWWWWWWEEWW
WWWWWWEEEEEEEWWEXWWEEWW
VVVVWWWWEEEEEWWEEWWEEWW
VVVVWWWWEEEEEWWEEWWEEWW
VVVVVVWWEEEEEEEEEEEEEWW
VVVVVVWWEEEEEWWWWWWEEWW
VVVVVVWWWWWEWWWVVWWWWWW
VVVVVVWWWWWWWWWVVVVVVVV