15
5
VVVWWWWWWWWWWWV
WWWWEEEEWEEEEWW
WEEWEEWEWEEEECW
WWEEEEWEEEEWWWW
VWWWWWWWWWWWVVV