11
9
WWWWWWWWWWW
WEEEEEEEEEW
WEEEWWWWWEW
WEEEEXWEWEW
WEEEEEWEWEW
WWWEEEWEWWW
EEWWWEWEEEE
EEEEWEWEEEE
EEEEWWWEEEE