31
15
WWWWWWWWWWWWWWWWWWWWWWWWWWWWWWW
WWWWWWWWWWWWWWWEWWWWWWWWWWWWWWW
WWXEEEEEEEEEWWEEEWWEEEEEEEEEXWW
WWEEEEEEEEEEWWEEEWWEEEEEEEEEEWW
WWWWWWWWWEEEWWEEEWWEEEWWWWWWWWW
WWWWWWWWWEEEWWEEEWWEEEWWWWWWWWW
WWEEEEEEEEEEEEEEEEEEEEEEEEEEEWW
WEEEEEEEEEEEEEEEEEEEEEEEEEEEEEW
WWEEEEEEEEEEEEEEEEEEEEEEEEEEEWW
WWWWWWWWWEEEWWEEEWWEEEWWWWWWWWW
WWWWWWWWWEEEWWEEEWWEEEWWWWWWWWW
WWEEEEEEEEEEWWEEEWWEEEEEEEEEEWW
WWXEEEEEEEEEWWEEEWWEEEEEEEEEXWW
WWWWWWWWWWWWWWWEWWWWWWWWWWWWWWW
WWWWWWWWWWWWWWWWWWWWWWWWWWWWWWW