35
19
VVVVVVWWWWWWWWWWWWWWWWWWWWWWWWWWWVV
VVVVVVWWWWWWWWWWWEWWWWWWWWWWWWWWWVV
VVVVWWWWEEEEEEEEEEEEEEEEEEEEEEXWWWW
VVVVWWWWEEEEEEEEEEEEEEEEEEEEEEEWWWW
VVWWWWXEEEEEEEEEEEEEEEEEEEEEEEEEEWW
VVWWWWEEEEEEEEEEEEEEEEEEEEEEEEEEEWW
WWWWEEEEEEEEEEEEEEEEEEEEEEEWWEEEEWW
WWWWEEEEEEEEEEEEEEEEEEEEEEEWWEEEEWW
WWEEEEEEEEEEEEEEWWWEEEEEEEEEEEEEEWW
WEEEEEEEEEEEEEEEWWWEEEEEEEEEEEEEEEW
WWEEEEEEEEEEEEEEWWWEEEEEEEEEEEEEEWW
WWEEEEWWEEEEEEEEEEEEEEEEEEEEEEEWWWW
WWEEEEWWEEEEEEEEEEEEEEEEEEEEEEEWWWW
WWEEEEEEEEEEEEEEEEEEEEEEEEEEEWWWWVV
WWEEEEEEEEEEEEEEEEEEEEEEEEEEXWWWWVV
WWWWEEEEEEEEEEEEEEEEEEEEEEEWWWWVVVV
WWWWXEEEEEEEEEEEEEEEEEEEEEEWWWWVVVV
VVWWWWWWWWWWWWWWWEWWWWWWWWWWWVVVVVV
VVWWWWWWWWWWWWWWWWWWWWWWWWWWWVVVVVV
