17
17
WWWWWWWWWWWWWWWWW
WVVVVVVVVVVVVVVVW
WVVVVVVVVVVVVVVVW
WVVWWVVVVVVVVVVVW
WVVVWVWWWWWVVVVVW
WVVVWVXWVVVVVVVVW
WVVVWVVWVVVVVVVVW
WVVVWVVWVVVWVVVVW
WVVVWVVWXVVWVVVVW
WVVVWVVWWWWWWVVVW
WVVVVVVVXWVVWVVVW
WVVVVVVVVWVVWVVVW
WVVVVVWWWWVVVVVVW
WVVVVVVVVWVVVVVVW
WVVVVVVVVVVVVVVVW
WVVVVVVVVVVVVVVVW
WWWWWWWWWWWWWWWWW