25
25
WWWWWWWWWWWWWWWWWWWWWWWWW
WEEEEEEEEEEEEEEEEEEEEEEEW
WEEEEEEEEEEEEEEEEEEEEEEEW
WEEEEWWWEEEWWWEEEWWWEEEEW
WEEEEEEEEEEEEEEEEEEEEEEEW
WEEWEEEEEEEEEEEEEEEEEWEEW
WEEWEEEEWWWEEEWWWEEEEWEEW
WEEWEEEEEEEEEEEEEEEEEWEEW
WEEEEEWEEEEEEEEEEEWEEEEEW
WEEEEEWEEEEWWWEEEEWEEEEEW
WEEEEEWEEEEEEEEEEEWEEEEEW
WEEWEEEEEWEEEEEWEEEEEWEEW
WEEWEEEEEWEEWEEWEEEEEWEEW
WEEWEEEEEWEEEEEWEEEEEWEEW
WEEEEEWEEEEEEEEEEEWEEEEEW
WEEEEEWEEEEWWWEEEEWEEEEEW
WEEEEEWEEEEEEEEEEEWEEEEEW
WEEWEEEEEEEEEEEEEEEEEWEEW
WEEWEEEEWWWEEEWWWEEEEWEEW
WEEWEEEEEEEEEEEEEEEEEWEEW
WEEEEEEEEEEEEEEEEEEEEEEEW
WEEEEWWWEEEWWWEEEWWWEEEEW
WEEEEEEEEEEEEEEEEEEEEEEEW
WEEEEEEEEEEEEEEEEEEEEEEEW
WWWWWWWWWWWWWWWWWWWWWWWWW