25
25
EEEEEEEWWWWWWWWWWWEEEEEEE
EEWWWWWWEEEEEEEEEWWWWWWEE
EWWEEEEEEEEEEEEEEEEEEEWWE
EWEEEEEEEEEEEEEEEEEEEEEWE
EWEEWWWWEEEEEEEEEWWWWEEWE
EWEEWEEWWEEEEEEEWWEEWEEWE
EWEEWEEEWWEEEEEWWEEEWEEWE
WWEEWWEEEWEEEEEWEEEWWEEWW
WEEEEWWEEWEEEEEWEEWWEEEEW
WEEEEEWWWWEEEEEWWWWEEEEEW
WEEEEEEEEEEEEEEEEEEEEEEEW
WEEEEEEEEEEEEEEEEEEEEEEEW
WEEEEEEEEEEEEEEEEEEEEEEEW
WEEEEEEEEEEEEEEEEEEEEEEEW
WEEEEEEEEEEEEEEEEEEEEEEEW
WEEEEEWWWWEEEEEWWWWEEEEEW
WEEEEWWEEWEEEEEWEEWWEEEEW
WWEEWWEEEWEEEEEWEEEWWEEWW
EWEEWEEEWWEEEEEWWEEEWEEWE
EWEEWEEWWEEEEEEEWWEEWEEWE
EWEEWWWWEEEEEEEEEWWWWEEWE
EWEEEEEEEEEEEEEEEEEEEEEWE
EWWEEEEEEEEEEEEEEEEEEEWWE
EEWWWWWWEEEEEEEEEWWWWWWEE
EEEEEEEWWWWWWWWWWWEEEEEEE