25
25
WWWWWWWWWWWWWWWWWWWWWWWWW
WEEEEEEEEEEEEEEEEEEEEEEEW
WEEEEEEEEEEEEEEEEEEEEEEEW
WEEEEEEEEEEEEEEEEEEEEEEEW
WEEEWWWWWEEWWWEEWWWWWEEEW
WEEEWEEEEEEEEEEEEEEEWEEEW
WEEEWEEEEEEEEEEEEEEEWEEEW
WEEEWEEWWWWEEEWWWWEEWEEEW
WEEEWEEWEEEEEEEEEWEEWEEEW
WEEEEEEWEEEEEEEEEWEEEEEEW
WEEEEEEWEEEEEEEEEWEEEEEEW
WEEEWEEEEEEEEEEEEEEEWEEEW
WEEEWEEEEEEEBEEEEEEEWEEEW
WEEEWEEEEEEEEEEEEEEEWEEEW
WEEEEEEWEEEEEEEEEWEEEEEEW
WEEEEEEWEEEEEEEEEWEEEEEEW
WEEEEEEWEEEEEEEEEWEEWEEEW
WEEEWEEWWWWEEEWWWWEEWEEEW
WEEEWEEEEEEEEEEEEEEEWEEEW
WEEEWEEEEEEEEEEEEEEEWEEEW
WEEEWWWWWEEWWWEEWWWWWEEEW
WEEEEEEEEEEEEEEEEEEEEEEEW
WEEEEEEEEEEEEEEEEEEEEEEEW
WEEEEEEEEEEEEEEEEEEEEEEEW
WWWWWWWWWWWWWWWWWWWWWWWWW