7
7
WWWWWWW
WEEEEEW
WEEEEEW
WEEEEEW
WEEEEEW
WCEEEEW
WWWWWWW