9
9
EEEWWWEEE
EEWEEEWEE
EWEEEEEWE
WEEEEEEEW
WEEEEEEEW
WEEEEEEEW
EWEEEEEWE
EEWEEEWEE
EEEWWWEEE