11,11
WWWWWWWWWWW
WEEEEEEEEEW
WEWEEXEEWEW
WEEEEEEEEEW
WEEEWWWEEEW
WEEEWWWEEEW
WEEEWWWEEEW
WEEEEEEEEEW
WEWEEXEEWEW
WEEEEEEEEEW
WWWWWWWWWWW