21
21
WWWWWWWWWWWWWWWWWWWWW
WEEEEEEEEEEEEEEEEEEEW
WEEEEEEEEEEEEEEEEEEEW
WEEEEEEEEEEEEEEEEEEEW
WEEEWWWEEEEEEEWWWEEEW
WEEEWWWEEEEEEEWWWEEEW
WEEEWWWEEEEEEEWWWEEEW
WEEEEEEEEEEEEEEEEEEEW
WEEEEEEEEEEEEEEEEEEEW
WEEEEEEEEEEEEEEEEEEEW
WEEEEEEEEEEEEEEEEEEEW
WEEEEEEEEEEEEEEEEEEEW
WEEEEEEEEEEEEEEEEEEEW
WEEEEEEEEEEEEEEEEEEEW
WEEEWWWEEEEEEEWWWEEEW
WEEEWWWEEEEEEEWWWEEEW
WEEEWWWEEEEEEEWWWEEEW
WEEEEEEEEEEEEEEEEEEEW
WEEEEEEEEEEEEEEEEEEEW
WEEEEEEEEEEEEEEEEEEEW
WWWWWWWWWWWWWWWWWWWWW