17
9
EEEWWWWWWWWWWWWWE
EEWWEEEEEEEEEEEWW
EWWEEEEEEEEEEEEEW
WWEEEEEEEEEEEWEEW
WEEEEEEEWEEEEEEEW
WEEWEEEEEEEEEEEWW
WEEEEEEEEEEEEEWWE
WWEEEEEEEEEEEWWEE
EWWWWWWWWWWWWWEEE